%%%%%%%
% P   %
%.%%% %
% %.  %
% %%% %
%  G  %
%%%%%%%
